ACACTCTTTCCCTACACGACGCTCTTCCGATCTTGAACCAGTACCATATT	AGTACCATAT
ACACTCTTTCCCTACACGACGCTCTTCCGATCTCCTTCACTCATCTCATT	CTCATCTCAT
ACACTCTTTCCCTACACGACGCTCTTCCGATCTAGTCTGATCGGCATGAT	ATCGGCATGA
ACACTCTTTCCCTACACGACGCTCTTCCGATCTCTACGATCGGTTCTGT	TCGGTTCTG
ACACTCTTTCCCTACACGACGCTCTTCCGATCTGACAGATCCAGTCTGT	TCCAGTCTG
ACACTCTTTCCCTACACGACGCTCTTCCGATCTTACGACGAACCTGTGT	GAACCTGTG
ACACTCTTTCCCTACACGACGCTCTTCCGATCTTCTGAGAGCCAGAGATT	AGCCAGAGAT
ACACTCTTTCCCTACACGACGCTCTTCCGATCTCTCGTTCAATGACT	CAATGAC
ACACTCTTTCCCTACACGACGCTCTTCCGATCTGAGTGAGATCAAGT	GATCAAG
ACACTCTTTCCCTACACGACGCTCTTCCGATCTTGATCGTGGTATCT	TGGTATC
ACACTCTTTCCCTACACGACGCTCTTCCGATCTGTGCTTAACTGTGT	AACTGTG
ACACTCTTTCCCTACACGACGCTCTTCCGATCTAGAACGAGTTCAGATT	AGTTCAGAT
ACACTCTTTCCCTACACGACGCTCTTCCGATCTGGCTTATTCGAGATT	TTCGAGAT
ACACTCTTTCCCTACACGACGCTCTTCCGATCTACACACGGAGAACTT	GGAGAACT
ACACTCTTTCCCTACACGACGCTCTTCCGATCTAAGTCCTTAGTGGTT	TTAGTGGT
ACACTCTTTCCCTACACGACGCTCTTCCGATCTTGGCTTGCTTCCTGT	GCTTCCTG
ACACTCTTTCCCTACACGACGCTCTTCCGATCTTAGTCGCATTCTGT	CATTCTG
ACACTCTTTCCCTACACGACGCTCTTCCGATCTTCTGGATTGATCGT	TTGATCG
ACACTCTTTCCCTACACGACGCTCTTCCGATCTCCAGATAGAATCGATT	AGAATCGAT
ACACTCTTTCCCTACACGACGCTCTTCCGATCTCTTGAGCACACGTATT	CACACGTAT
ACACTCTTTCCCTACACGACGCTCTTCCGATCTCTCAAGCTATGGATAAT	CTATGGATAA
ACACTCTTTCCCTACACGACGCTCTTCCGATCTAGCGATGCACGAATT	GCACGAAT
ACACTCTTTCCCTACACGACGCTCTTCCGATCTGTGTGTCCGTTCTAT	CCGTTCTA
ACACTCTTTCCCTACACGACGCTCTTCCGATCTCACGTACCGCTTATATT	CCGCTTATAT
ACACTCTTTCCCTACACGACGCTCTTCCGATCTCACAACGGAGCTTATT	GGAGCTTAT
ACACTCTTTCCCTACACGACGCTCTTCCGATCTAGTGAGACCAATGTCT	ACCAATGTC
ACACTCTTTCCCTACACGACGCTCTTCCGATCTCTTGGTCCTATCAGATT	CCTATCAGAT
ACACTCTTTCCCTACACGACGCTCTTCCGATCTTGACGTCACATTGAGAT	CACATTGAGA
ACACTCTTTCCCTACACGACGCTCTTCCGATCTAGCAAGAAGTGGTAT	AAGTGGTA
ACACTCTTTCCCTACACGACGCTCTTCCGATCTTGCTTCGTAGAGTAT	GTAGAGTA
ACACTCTTTCCCTACACGACGCTCTTCCGATCTACCACAGTTCTCGT	GTTCTCG
ACACTCTTTCCCTACACGACGCTCTTCCGATCTAAGCGATCACGTGT	TCACGTG
ACACTCTTTCCCTACACGACGCTCTTCCGATCTGTGACTAATCAGGT	AATCAGG
ACACTCTTTCCCTACACGACGCTCTTCCGATCTGCCATTGCTTATGT	GCTTATG
ACACTCTTTCCCTACACGACGCTCTTCCGATCTTCTCACAGGTACCACT	AGGTACCAC
ACACTCTTTCCCTACACGACGCTCTTCCGATCTGGACTTGTAAGCATATT	GTAAGCATAT
ACACTCTTTCCCTACACGACGCTCTTCCGATCTTACCTCAACAACGACT	AACAACGAC
ACACTCTTTCCCTACACGACGCTCTTCCGATCTGTCCAATCGTCGTAT	TCGTCGTA
ACACTCTTTCCCTACACGACGCTCTTCCGATCTCCACTTCTCCATATT	CTCCATAT
ACACTCTTTCCCTACACGACGCTCTTCCGATCTACTACGACTGCACTT	ACTGCACT
ACACTCTTTCCCTACACGACGCTCTTCCGATCTTTGCCACCAACATCT	CCAACATC
ACACTCTTTCCCTACACGACGCTCTTCCGATCTCCTTAGATTCCTCATT	ATTCCTCAT
ACACTCTTTCCCTACACGACGCTCTTCCGATCTGTGTACTGTGCCACATT	TGTGCCACAT
ACACTCTTTCCCTACACGACGCTCTTCCGATCTGCATCATTGGTTCT	TTGGTTC
ACACTCTTTCCCTACACGACGCTCTTCCGATCTGATGAGTCACCACT	TCACCAC
ACACTCTTTCCCTACACGACGCTCTTCCGATCTCTATCGTGACTGATAAT	TGACTGATAA
ACACTCTTTCCCTACACGACGCTCTTCCGATCTTACGGATGCCAATT	TGCCAAT
ACACTCTTTCCCTACACGACGCTCTTCCGATCTTGTGTGTACGACATAAT	TACGACATAA
ACACTCTTTCCCTACACGACGCTCTTCCGATCTTGATGCGAAGTAGATT	GAAGTAGAT
ACACTCTTTCCCTACACGACGCTCTTCCGATCTGTTGCACGTCCTTCAAT	CGTCCTTCAA
ACACTCTTTCCCTACACGACGCTCTTCCGATCTCGGTATGTCGATGT	GTCGATG
ACACTCTTTCCCTACACGACGCTCTTCCGATCTTCAACGTTCCAACT	TTCCAAC
ACACTCTTTCCCTACACGACGCTCTTCCGATCTCTAAGGCTTCCAGT	CTTCCAG
ACACTCTTTCCCTACACGACGCTCTTCCGATCTGAGAACAAGGTCGT	AAGGTCG
ACACTCTTTCCCTACACGACGCTCTTCCGATCTGTAAGCTAACGCCT	TAACGCC
ACACTCTTTCCCTACACGACGCTCTTCCGATCTGGAAGTACGGAATCTAT	ACGGAATCTA
ACACTCTTTCCCTACACGACGCTCTTCCGATCTAGCTGTGTGTAGATAAT	GTGTAGATAA
ACACTCTTTCCCTACACGACGCTCTTCCGATCTGATGGACCTGGAATAAT	CCTGGAATAA
ACACTCTTTCCCTACACGACGCTCTTCCGATCTCTGAGTAACAACCT	AACAACC
ACACTCTTTCCCTACACGACGCTCTTCCGATCTGAACAGCATCGGTCAAT	CATCGGTCAA
ACACTCTTTCCCTACACGACGCTCTTCCGATCTGAATGCAGGATACT	AGGATAC
ACACTCTTTCCCTACACGACGCTCTTCCGATCTATCCTCTGCCAATCT	TGCCAATC
ACACTCTTTCCCTACACGACGCTCTTCCGATCTCTGGTACAATGCTCT	CAATGCTC
ACACTCTTTCCCTACACGACGCTCTTCCGATCTCCAAGTGACCATTCT	GACCATTC
ACACTCTTTCCCTACACGACGCTCTTCCGATCTTTCGAGTGTTGGTCT	TGTTGGTC
ACACTCTTTCCCTACACGACGCTCTTCCGATCTTTCCGTCTCGTATCGTT	CTCGTATCGT
ACACTCTTTCCCTACACGACGCTCTTCCGATCTAGGAGTAACACAGATT	AACACAGAT
ACACTCTTTCCCTACACGACGCTCTTCCGATCTAACGCACCTTCCTCT	CCTTCCTC
ACACTCTTTCCCTACACGACGCTCTTCCGATCTAATCGCGCAGTTAGT	GCAGTTAG
ACACTCTTTCCCTACACGACGCTCTTCCGATCTCTCGAACTGAGAATT	CTGAGAAT
ACACTCTTTCCCTACACGACGCTCTTCCGATCTTCACTCTTCAGGTGT	TTCAGGTG
ACACTCTTTCCCTACACGACGCTCTTCCGATCTGAGTAGCAACAGCATT	CAACAGCAT
ACACTCTTTCCCTACACGACGCTCTTCCGATCTCAACCAGTGCATAGATT	GTGCATAGAT
ACACTCTTTCCCTACACGACGCTCTTCCGATCTGATGTCGGAATTCT	GGAATTC
ACACTCTTTCCCTACACGACGCTCTTCCGATCTAAGCCAGGTCTGTGAAT	GGTCTGTGAA
ACACTCTTTCCCTACACGACGCTCTTCCGATCTCAACTGAAGCTGCT	AAGCTGC
ACACTCTTTCCCTACACGACGCTCTTCCGATCTGTTGTGAAGCGTAGATT	AAGCGTAGAT
ACACTCTTTCCCTACACGACGCTCTTCCGATCTGTTCGACCAGTGTGAAT	CCAGTGTGAA
ACACTCTTTCCCTACACGACGCTCTTCCGATCTAAGACGCTGGTTGT	CTGGTTG
ACACTCTTTCCCTACACGACGCTCTTCCGATCTCCAATCGTCTTGGT	GTCTTGG
ACACTCTTTCCCTACACGACGCTCTTCCGATCTATCTCCACAAGCTATT	ACAAGCTAT
ACACTCTTTCCCTACACGACGCTCTTCCGATCTACCTAGAGAGGATTCT	AGAGGATTC
ACACTCTTTCCCTACACGACGCTCTTCCGATCTAGTCCTCTGTCTCATT	CTGTCTCAT
ACACTCTTTCCCTACACGACGCTCTTCCGATCTAGAGACACACTTCATT	ACACTTCAT
ACACTCTTTCCCTACACGACGCTCTTCCGATCTGACACTCGAAGGTGCTT	CGAAGGTGCT
ACACTCTTTCCCTACACGACGCTCTTCCGATCTACCTGAGGTAAGGATT	GGTAAGGAT
ACACTCTTTCCCTACACGACGCTCTTCCGATCTGTCACAGTGACAAGCTT	GTGACAAGCT
ACACTCTTTCCCTACACGACGCTCTTCCGATCTAGCTTGAATTGCCATT	AATTGCCAT
ACACTCTTTCCCTACACGACGCTCTTCCGATCTTGTCTCGCAATGGATT	GCAATGGAT
ACACTCTTTCCCTACACGACGCTCTTCCGATCTTCGCATGAGACTCATT	GAGACTCAT
ACACTCTTTCCCTACACGACGCTCTTCCGATCTAAGCAGACGCCATATT	ACGCCATAT
ACACTCTTTCCCTACACGACGCTCTTCCGATCTCGGTTATCCAGGATT	TCCAGGAT
ACACTCTTTCCCTACACGACGCTCTTCCGATCTCTGCTTGGTGGTAGT	GGTGGTAG
ACACTCTTTCCCTACACGACGCTCTTCCGATCTTGGTGTACGTCTAGT	ACGTCTAG
ACACTCTTTCCCTACACGACGCTCTTCCGATCTTCCATCTGGAGTAGT	TGGAGTAG
ACACTCTTTCCCTACACGACGCTCTTCCGATCTTCTGCTCTAACGGATT	CTAACGGAT
