GTGACTGGAGTTCAGACGTGTGCTCTTCCGATCTGGTTCAATATGGTACTT	ATATGGTACT
GTGACTGGAGTTCAGACGTGTGCTCTTCCGATCTTGAAGGATGAGATGAGT	ATGAGATGAG
GTGACTGGAGTTCAGACGTGTGCTCTTCCGATCTCAGACTTCATGCCGATT	TCATGCCGAT
GTGACTGGAGTTCAGACGTGTGCTCTTCCGATCTTCGTAGCAGAACCGAT	CAGAACCGA
GTGACTGGAGTTCAGACGTGTGCTCTTCCGATCTTCTGTCCAGACTGGAT	CAGACTGGA
GTGACTGGAGTTCAGACGTGTGCTCTTCCGATCTGTCGTACACAGGTTCT	CACAGGTTC
GTGACTGGAGTTCAGACGTGTGCTCTTCCGATCTCTCAGAATCTCTGGCTT	ATCTCTGGCT
GTGACTGGAGTTCAGACGTGTGCTCTTCCGATCTAACGAGGTCATTGT	GTCATTG
GTGACTGGAGTTCAGACGTGTGCTCTTCCGATCTTCACTCCTTGATCT	CTTGATC
GTGACTGGAGTTCAGACGTGTGCTCTTCCGATCTCGATCAGATACCAT	GATACCA
GTGACTGGAGTTCAGACGTGTGCTCTTCCGATCTAAGCACCACAGTTT	CACAGTT
GTGACTGGAGTTCAGACGTGTGCTCTTCCGATCTCGTTCTATCTGAACTT	ATCTGAACT
GTGACTGGAGTTCAGACGTGTGCTCTTCCGATCTTAAGCCATCTCGAAT	ATCTCGAA
GTGACTGGAGTTCAGACGTGTGCTCTTCCGATCTGTGTGTAGTTCTCCT	AGTTCTCC
GTGACTGGAGTTCAGACGTGTGCTCTTCCGATCTGGACTTACCACTAAT	ACCACTAA
GTGACTGGAGTTCAGACGTGTGCTCTTCCGATCTAAGCCACAGGAAGCT	CAGGAAGC
GTGACTGGAGTTCAGACGTGTGCTCTTCCGATCTCGACTACAGAATGT	CAGAATG
GTGACTGGAGTTCAGACGTGTGCTCTTCCGATCTTCCAGACGATCAAT	CGATCAA
GTGACTGGAGTTCAGACGTGTGCTCTTCCGATCTATCTGGATCGATTCTT	ATCGATTCT
GTGACTGGAGTTCAGACGTGTGCTCTTCCGATCTCTCAAGATACGTGTGT	ATACGTGTG
GTGACTGGAGTTCAGACGTGTGCTCTTCCGATCTCTTGAGTTATCCATAGT	TTATCCATAG
GTGACTGGAGTTCAGACGTGTGCTCTTCCGATCTATCGCTATTCGTGCT	ATTCGTGC
GTGACTGGAGTTCAGACGTGTGCTCTTCCGATCTACACACTAGAACGGT	TAGAACGG
GTGACTGGAGTTCAGACGTGTGCTCTTCCGATCTTACGTGATATAAGCGGT	ATATAAGCGG
GTGACTGGAGTTCAGACGTGTGCTCTTCCGATCTGTTGTGATAAGCTCCT	ATAAGCTCC
GTGACTGGAGTTCAGACGTGTGCTCTTCCGATCTCTCACTGACATTGGTT	GACATTGGT
GTGACTGGAGTTCAGACGTGTGCTCTTCCGATCTACCAAGATCTGATAGGT	ATCTGATAGG
GTGACTGGAGTTCAGACGTGTGCTCTTCCGATCTACGTCATCTCAATGTGT	TCTCAATGTG
GTGACTGGAGTTCAGACGTGTGCTCTTCCGATCTCTTGCTTACCACTTT	TACCACTT
GTGACTGGAGTTCAGACGTGTGCTCTTCCGATCTGAAGCATACTCTACT	TACTCTAC
GTGACTGGAGTTCAGACGTGTGCTCTTCCGATCTTGTGGTCGAGAACT	CGAGAAC
GTGACTGGAGTTCAGACGTGTGCTCTTCCGATCTTCGCTTCACGTGAT	CACGTGA
GTGACTGGAGTTCAGACGTGTGCTCTTCCGATCTAGTCACCCTGATTT	CCTGATT
GTGACTGGAGTTCAGACGTGTGCTCTTCCGATCTAATGGCCATAAGCT	CATAAGC
GTGACTGGAGTTCAGACGTGTGCTCTTCCGATCTGTGAGAGTGGTACCTT	GTGGTACCT
GTGACTGGAGTTCAGACGTGTGCTCTTCCGATCTAAGTCCATATGCTTACT	ATATGCTTAC
GTGACTGGAGTTCAGACGTGTGCTCTTCCGATCTGAGGTAGTCGTTGTTT	GTCGTTGTT
GTGACTGGAGTTCAGACGTGTGCTCTTCCGATCTTTGGACTACGACGAT	TACGACGA
GTGACTGGAGTTCAGACGTGTGCTCTTCCGATCTAAGTGGATATGGAGT	ATATGGAG
GTGACTGGAGTTCAGACGTGTGCTCTTCCGATCTCGTAGTAGTGCAGTT	AGTGCAGT
GTGACTGGAGTTCAGACGTGTGCTCTTCCGATCTTGGCAAGATGTTGGT	GATGTTGG
GTGACTGGAGTTCAGACGTGTGCTCTTCCGATCTCTAAGGATGAGGAATT	ATGAGGAAT
GTGACTGGAGTTCAGACGTGTGCTCTTCCGATCTGTACACATGTGGCACAT	ATGTGGCACA
GTGACTGGAGTTCAGACGTGTGCTCTTCCGATCTTGATGCGAACCAAT	GAACCAA
GTGACTGGAGTTCAGACGTGTGCTCTTCCGATCTCTCATCGTGGTGAT	GTGGTGA
GTGACTGGAGTTCAGACGTGTGCTCTTCCGATCTCGATAGTTATCAGTCAT	TTATCAGTCA
GTGACTGGAGTTCAGACGTGTGCTCTTCCGATCTTCCGTAATTGGCAT	ATTGGCA
GTGACTGGAGTTCAGACGTGTGCTCTTCCGATCTCACACATTATGTCGTAT	TTATGTCGTA
GTGACTGGAGTTCAGACGTGTGCTCTTCCGATCTGCATCAATCTACTTCT	ATCTACTTC
GTGACTGGAGTTCAGACGTGTGCTCTTCCGATCTTGCAACTTGAAGGACGT	TTGAAGGACG
GTGACTGGAGTTCAGACGTGTGCTCTTCCGATCTATACCGCATCGACT	CATCGAC
GTGACTGGAGTTCAGACGTGTGCTCTTCCGATCTCGTTGAGTTGGAAT	GTTGGAA
GTGACTGGAGTTCAGACGTGTGCTCTTCCGATCTCCTTAGCTGGAAGT	CTGGAAG
GTGACTGGAGTTCAGACGTGTGCTCTTCCGATCTGTTCTCCGACCTTT	CGACCTT
GTGACTGGAGTTCAGACGTGTGCTCTTCCGATCTGCTTACGGCGTTAT	GGCGTTA
GTGACTGGAGTTCAGACGTGTGCTCTTCCGATCTACTTCCTAGATTCCGTT	TAGATTCCGT
GTGACTGGAGTTCAGACGTGTGCTCTTCCGATCTACAGCTTTATCTACACT	TTATCTACAC
GTGACTGGAGTTCAGACGTGTGCTCTTCCGATCTTCCATCTTATTCCAGGT	TTATTCCAGG
GTGACTGGAGTTCAGACGTGTGCTCTTCCGATCTACTCAGGGTTGTTT	GGTTGTT
GTGACTGGAGTTCAGACGTGTGCTCTTCCGATCTCTGTTCTTGACCGATGT	TTGACCGATG
GTGACTGGAGTTCAGACGTGTGCTCTTCCGATCTGCATTCGTATCCTT	GTATCCT
GTGACTGGAGTTCAGACGTGTGCTCTTCCGATCTGAGGATGATTGGCAT	GATTGGCA
GTGACTGGAGTTCAGACGTGTGCTCTTCCGATCTTACCAGGAGCATTGT	GAGCATTG
GTGACTGGAGTTCAGACGTGTGCTCTTCCGATCTACTTGGGAATGGTCT	GAATGGTC
GTGACTGGAGTTCAGACGTGTGCTCTTCCGATCTCTCGAAGACCAACAT	GACCAACA
GTGACTGGAGTTCAGACGTGTGCTCTTCCGATCTACGGAAACGATACGAGT	ACGATACGAG
GTGACTGGAGTTCAGACGTGTGCTCTTCCGATCTACTCCTATCTGTGTTT	ATCTGTGTT
GTGACTGGAGTTCAGACGTGTGCTCTTCCGATCTTGCGTTGAGGAAGGT	GAGGAAGG
GTGACTGGAGTTCAGACGTGTGCTCTTCCGATCTGCGATTCTAACTGCT	CTAACTGC
GTGACTGGAGTTCAGACGTGTGCTCTTCCGATCTTTCGAGATTCTCAGT	ATTCTCAG
GTGACTGGAGTTCAGACGTGTGCTCTTCCGATCTGAGTGACACCTGAAT	CACCTGAA
GTGACTGGAGTTCAGACGTGTGCTCTTCCGATCTCTACTCATGCTGTTGT	ATGCTGTTG
GTGACTGGAGTTCAGACGTGTGCTCTTCCGATCTTGGTTGATCTATGCACT	ATCTATGCAC
GTGACTGGAGTTCAGACGTGTGCTCTTCCGATCTGACATCGAATTCCT	GAATTCC
GTGACTGGAGTTCAGACGTGTGCTCTTCCGATCTTGGCTTTTCACAGACCT	TTCACAGACC
GTGACTGGAGTTCAGACGTGTGCTCTTCCGATCTCAGTTGGCAGCTTT	GCAGCTT
GTGACTGGAGTTCAGACGTGTGCTCTTCCGATCTCACAACATCTACGCTTT	ATCTACGCTT
GTGACTGGAGTTCAGACGTGTGCTCTTCCGATCTTCGAACTTCACACTGGT	TTCACACTGG
GTGACTGGAGTTCAGACGTGTGCTCTTCCGATCTCGTCTTCAACCAGT	CAACCAG
GTGACTGGAGTTCAGACGTGTGCTCTTCCGATCTGATTGGCCAAGACT	CCAAGAC
GTGACTGGAGTTCAGACGTGTGCTCTTCCGATCTGGAGATATAGCTTGTT	ATAGCTTGT
GTGACTGGAGTTCAGACGTGTGCTCTTCCGATCTCTAGGTGAATCCTCTT	GAATCCTCT
GTGACTGGAGTTCAGACGTGTGCTCTTCCGATCTAGGACTATGAGACAGT	ATGAGACAG
GTGACTGGAGTTCAGACGTGTGCTCTTCCGATCTGTCTCTATGAAGTGTT	ATGAAGTGT
GTGACTGGAGTTCAGACGTGTGCTCTTCCGATCTAGTGTCAGCACCTTCGT	AGCACCTTCG
GTGACTGGAGTTCAGACGTGTGCTCTTCCGATCTTCAGGTATCCTTACCT	ATCCTTACC
GTGACTGGAGTTCAGACGTGTGCTCTTCCGATCTTGTGACAGCTTGTCACT	AGCTTGTCAC
GTGACTGGAGTTCAGACGTGTGCTCTTCCGATCTCAAGCTATGGCAATTT	ATGGCAATT
GTGACTGGAGTTCAGACGTGTGCTCTTCCGATCTGAGACAATCCATTGCT	ATCCATTGC
GTGACTGGAGTTCAGACGTGTGCTCTTCCGATCTATGCGAATGAGTCTCT	ATGAGTCTC
GTGACTGGAGTTCAGACGTGTGCTCTTCCGATCTCTGCTTATATGGCGTT	ATATGGCGT
GTGACTGGAGTTCAGACGTGTGCTCTTCCGATCTTAACCGATCCTGGAT	ATCCTGGA
GTGACTGGAGTTCAGACGTGTGCTCTTCCGATCTAAGCAGCTACCACCT	CTACCACC
GTGACTGGAGTTCAGACGTGTGCTCTTCCGATCTACACCACTAGACGTT	CTAGACGT
GTGACTGGAGTTCAGACGTGTGCTCTTCCGATCTGATGGACTACTCCAT	CTACTCCA
GTGACTGGAGTTCAGACGTGTGCTCTTCCGATCTAGCAGAATCCGTTAGT	ATCCGTTAG
