ACACTCTTTCCCTACACGACGCTCTTCCGATCTGCATG	GCATG
ACACTCTTTCCCTACACGACGCTCTTCCGATCTAACCA	AACCA
ACACTCTTTCCCTACACGACGCTCTTCCGATCTCGATC	CGATC
ACACTCTTTCCCTACACGACGCTCTTCCGATCTTCGAT	TCGAT
ACACTCTTTCCCTACACGACGCTCTTCCGATCTTGCAT	TGCAT
ACACTCTTTCCCTACACGACGCTCTTCCGATCTCAACC	CAACC
ACACTCTTTCCCTACACGACGCTCTTCCGATCTGGTTG	GGTTG
ACACTCTTTCCCTACACGACGCTCTTCCGATCTAAGGA	AAGGA
ACACTCTTTCCCTACACGACGCTCTTCCGATCTAGCTA	AGCTA
ACACTCTTTCCCTACACGACGCTCTTCCGATCTACACA	ACACA
ACACTCTTTCCCTACACGACGCTCTTCCGATCTAATTA	AATTA
ACACTCTTTCCCTACACGACGCTCTTCCGATCTACGGT	ACGGT
ACACTCTTTCCCTACACGACGCTCTTCCGATCTACTGG	ACTGG
ACACTCTTTCCCTACACGACGCTCTTCCGATCTACTTC	ACTTC
ACACTCTTTCCCTACACGACGCTCTTCCGATCTATACG	ATACG
ACACTCTTTCCCTACACGACGCTCTTCCGATCTATGAG	ATGAG
ACACTCTTTCCCTACACGACGCTCTTCCGATCTATTAC	ATTAC
ACACTCTTTCCCTACACGACGCTCTTCCGATCTCATAT	CATAT
ACACTCTTTCCCTACACGACGCTCTTCCGATCTCGAAT	CGAAT
ACACTCTTTCCCTACACGACGCTCTTCCGATCTCGGCT	CGGCT
ACACTCTTTCCCTACACGACGCTCTTCCGATCTCGGTA	CGGTA
ACACTCTTTCCCTACACGACGCTCTTCCGATCTCGTAC	CGTAC
ACACTCTTTCCCTACACGACGCTCTTCCGATCTCGTCG	CGTCG
ACACTCTTTCCCTACACGACGCTCTTCCGATCTCTGAT	CTGAT
ACACTCTTTCCCTACACGACGCTCTTCCGATCTCTGCG	CTGCG
ACACTCTTTCCCTACACGACGCTCTTCCGATCTCTGTC	CTGTC
ACACTCTTTCCCTACACGACGCTCTTCCGATCTCTTGG	CTTGG
ACACTCTTTCCCTACACGACGCTCTTCCGATCTGACAC	GACAC
ACACTCTTTCCCTACACGACGCTCTTCCGATCTGAGAT	GAGAT
ACACTCTTTCCCTACACGACGCTCTTCCGATCTGAGTC	GAGTC
ACACTCTTTCCCTACACGACGCTCTTCCGATCTGCCGT	GCCGT
ACACTCTTTCCCTACACGACGCTCTTCCGATCTGCTGA	GCTGA
ACACTCTTTCCCTACACGACGCTCTTCCGATCTGGATA	GGATA
ACACTCTTTCCCTACACGACGCTCTTCCGATCTGGCCA	GGCCA
ACACTCTTTCCCTACACGACGCTCTTCCGATCTGGCTC	GGCTC
ACACTCTTTCCCTACACGACGCTCTTCCGATCTGTAGT	GTAGT
ACACTCTTTCCCTACACGACGCTCTTCCGATCTGTCCG	GTCCG
ACACTCTTTCCCTACACGACGCTCTTCCGATCTGTCGA	GTCGA
ACACTCTTTCCCTACACGACGCTCTTCCGATCTTACCG	TACCG
ACACTCTTTCCCTACACGACGCTCTTCCGATCTTACGT	TACGT
ACACTCTTTCCCTACACGACGCTCTTCCGATCTTAGTA	TAGTA
ACACTCTTTCCCTACACGACGCTCTTCCGATCTTATAC	TATAC
ACACTCTTTCCCTACACGACGCTCTTCCGATCTTCACG	TCACG
ACACTCTTTCCCTACACGACGCTCTTCCGATCTTCAGT	TCAGT
ACACTCTTTCCCTACACGACGCTCTTCCGATCTTCCGG	TCCGG
ACACTCTTTCCCTACACGACGCTCTTCCGATCTTCTGC	TCTGC
ACACTCTTTCCCTACACGACGCTCTTCCGATCTTGGAA	TGGAA
ACACTCTTTCCCTACACGACGCTCTTCCGATCTTTACC	TTACC
